Maps/kanto_cities.png
6,113 7,113 6,113 7,113 6,113 7,113 6,113 7,113 6,113 7,113 6,113 7,113 3,64 5,64 6,113 7,113 6,113 7,113 6,113 7,113 6,113 7,113 6,113 7,113 6,113 7,113
6,114 7,114 6,114 7,114 6,114 7,114 6,114 7,114 6,114 7,114 6,114 7,114 3,64 5,64 6,114 7,114 6,114 7,114 6,114 7,114 6,114 7,114 6,114 7,114 6,114 7,114
6,118 7,118 6,118 7,118 6,118 7,118 6,118 7,118 6,118 7,118 6,118 7,118 3,64 5,64 6,118 7,118 6,118 7,118 6,118 7,118 6,118 7,118 6,118 7,118 6,118 7,118
6,113 7,113 3,63 4,63 4,63 4,63 4,63 4,63 4,63 4,63 4,63 4,63 4,64 4,64 4,63 4,63 4,63 4,63 4,63 4,63 4,63 4,63 4,63 5,63 6,113 7,113
6,114 7,114 3,64 4,64 4,64 4,64 4,64 4,64 4,64 4,64 4,64 4,64 4,64 4,64 4,64 4,64 4,64 4,64 4,64 4,64 4,64 4,64 4,64 5,64 6,114 7,114
6,118 7,118 3,64 4,64 4,64 4,64 4,64 4,64 4,64 4,64 4,64 4,64 4,64 4,64 4,64 4,64 4,64 4,64 4,64 4,64 4,64 4,64 4,64 5,64 6,118 7,118
6,113 7,113 3,64 4,64 4,64 4,64 4,64 4,64 4,64 4,64 4,64 4,64 4,64 4,64 4,64 4,64 4,64 4,64 4,64 4,64 4,64 4,64 4,64 5,64 6,113 7,113
6,114 7,114 3,64 4,64 4,64 4,64 4,64 4,64 4,64 4,64 4,64 4,64 4,64 4,64 4,64 4,64 4,64 4,64 4,64 4,64 4,64 4,64 4,64 5,64 6,114 7,114
6,118 7,118 3,64 4,64 4,64 4,64 4,64 4,64 4,64 4,64 4,64 4,64 4,64 4,64 4,64 4,64 4,64 4,64 4,64 4,64 4,64 4,64 4,64 5,64 6,118 7,118
6,113 7,113 3,64 4,64 4,64 4,64 4,64 4,64 4,64 4,64 4,64 4,64 4,64 4,64 4,64 4,64 4,64 4,64 4,64 4,64 4,64 4,64 4,64 5,64 6,113 7,113
6,114 7,114 3,64 4,64 4,64 4,64 4,64 4,64 4,64 4,64 4,64 4,64 4,64 4,64 4,64 4,64 4,64 4,64 4,64 4,64 4,64 4,64 4,64 5,64 6,114 7,114
6,118 7,118 3,64 4,64 4,64 4,64 4,64 4,64 4,64 4,64 4,64 4,64 4,64 4,64 4,64 4,64 4,64 4,64 4,64 4,64 4,64 4,64 4,64 5,64 6,118 7,118
6,113 7,113 3,64 4,64 4,64 4,64 4,64 4,64 4,64 4,64 4,64 4,64 4,64 4,64 4,64 4,64 4,64 4,64 4,64 4,64 4,64 4,64 4,64 5,64 6,113 7,113
6,114 7,114 3,64 4,64 4,64 4,64 4,64 4,64 4,64 4,64 4,64 4,64 4,64 4,64 4,64 4,64 4,64 4,64 4,64 4,64 4,64 4,64 4,64 5,64 6,114 7,114
6,118 7,118 3,64 4,64 4,64 4,64 4,64 4,64 4,64 4,64 4,64 4,64 4,64 4,64 4,64 4,64 4,64 4,64 4,64 4,64 4,64 4,64 4,64 5,64 6,118 7,118
6,113 7,113 3,64 4,64 4,64 4,64 4,64 4,64 4,64 4,64 4,64 4,64 4,64 4,64 4,64 4,64 4,64 4,64 4,64 4,64 4,64 4,64 4,64 5,64 6,113 7,113
6,114 7,114 3,64 4,64 4,64 4,64 4,64 4,64 4,64 4,64 4,64 4,64 4,64 4,64 4,64 4,64 4,64 4,64 4,64 4,64 4,64 4,64 4,64 5,64 6,114 7,114
6,118 7,118 3,64 4,64 4,64 4,64 4,64 4,64 4,64 4,64 4,64 4,64 4,64 4,64 4,64 4,64 4,64 4,64 4,64 4,64 4,64 4,64 4,64 5,64 6,118 7,118
6,113 7,113 3,64 4,64 4,64 4,64 4,64 4,64 4,64 4,64 4,64 4,64 4,64 4,64 4,64 4,64 4,64 4,64 4,64 4,64 4,64 4,64 4,64 5,64 6,113 7,113
6,114 7,114 3,64 4,64 4,64 4,64 4,64 4,64 4,64 4,64 4,64 4,64 4,64 4,64 4,64 4,64 4,64 4,64 4,64 4,64 4,64 4,64 4,64 5,64 6,114 7,114
6,118 7,118 3,64 4,64 4,64 4,64 4,64 4,64 4,64 4,64 4,64 4,64 4,64 4,64 4,64 4,64 4,64 4,64 4,64 4,64 4,64 4,64 4,64 5,64 6,118 7,118