Maps/kanto_cities.png
927,928,927,928,927,928,927,928,927,928,927,928,15,15,927,928,927,928,927,928,927,928,927,928,927,
53,53,62,45,46,53,46,54,45,60,45,60,15,15,52,61,61,60,62,62,46,52,53,61,1031,
1023,1024,1005,1006,1005,1006,1005,1006,1005,1006,1005,1006,15,15,1005,1006,1005,1006,1005,1006,1005,1006,1005,1006,1023,
1031,1032,60,61,62,54,60,53,62,45,45,45,15,15,52,54,44,61,45,53,62,53,45,62,1031,
1023,1024,60,191,141,141,141,141,141,141,141,141,141,141,141,141,141,141,141,141,141,141,192,44,1023,
1031,1032,60,199,215,157,157,157,157,157,157,157,157,157,157,157,157,157,157,157,157,183,200,44,1031,
1023,1024,46,199,150,1945,1946,1947,1948,1949,61,53,44,61,46,62,1945,1946,1947,1948,1949,199,200,44,1023,
1031,1032,52,199,150,1953,1954,1955,1956,1957,46,60,54,52,53,53,1953,1954,1955,1956,1957,199,200,53,1031,
1023,1024,46,199,150,1961,1962,1963,1964,1965,53,61,45,62,46,60,1961,1962,1963,1964,1965,199,200,62,1023,
1031,1032,61,199,150,62,52,44,45,53,46,52,61,60,54,60,61,53,53,60,62,199,200,44,1031,
1023,1024,54,199,150,54,60,44,44,62,53,53,45,52,44,52,61,44,44,62,62,199,200,44,1023,
1031,1032,62,199,176,141,141,141,141,141,141,141,141,141,141,141,141,141,141,141,141,167,200,52,1031,
1023,1024,44,207,157,157,157,157,157,216,149,215,157,157,157,157,157,157,149,149,157,157,208,45,61,
1031,1032,1865,1866,1867,1868,1869,1870,1871,148,149,150,3737,3738,3738,3738,3738,3738,3738,3738,3738,3738,3738,3738,3738,
1023,1024,1873,1874,1875,1876,1877,1878,1879,148,149,150,3745,1114,3754,3754,3754,3754,3754,3754,3754,3754,3754,3754,3754,
1031,1032,1881,1882,1883,1884,1885,1886,1887,148,149,150,3745,3747,52,62,44,53,149,149,61,61,44,54,1031,
1023,1024,1889,1890,1891,1892,1893,1894,1895,224,149,150,3745,3747,53,52,54,149,149,149,62,62,45,62,1023,
1031,1032,44,52,148,149,149,149,149,149,149,150,3745,3747,54,54,54,149,61,54,62,62,45,62,1031,
1023,1024,46,52,156,157,157,157,157,157,157,158,3745,3747,52,54,61,149,1825,1826,1827,1828,1829,54,1023,
1031,1032,44,46,60,61,61,62,62,60,1105,1106,1114,1114,1106,1107,62,149,1833,1834,1835,1836,1837,60,1031,
1023,1024,46,44,54,60,53,60,60,60,1113,1114,1114,1114,1114,1115,45,149,1841,1842,1843,1844,1845,45,1023,
1031,1032,62,46,62,60,52,54,53,62,1113,1114,1114,1114,1114,1115,53,149,1849,1850,1851,1852,1853,60,1031,
1023,1024,46,45,45,62,53,60,44,45,1113,1114,1114,1114,1114,1115,44,149,149,149,44,62,44,45,1023,
1031,1032,60,53,45,45,61,46,45,54,1113,1114,1114,1114,1114,1115,54,62,44,52,53,62,45,62,1031,
1023,1024,44,52,45,60,62,52,62,60,1113,1114,1114,1114,1114,1115,53,54,46,44,45,46,52,44,1023