Maps/kanto_inside.png
71,211,71,1668,1669,71,71,1730,71,71,71,71,71,1717,
218,219,553,1676,1677,1768,71,1738,71,71,30,31,71,1725,
226,227,561,1684,1685,1776,71,71,71,71,38,39,40,71,
71,71,71,71,71,71,71,71,71,71,46,47,48,71,
1523,1524,1525,71,52,53,53,53,54,71,71,71,71,71,
1531,1532,1533,71,60,61,61,61,62,71,1791,1383,1384,71,
1244,71,71,71,68,69,69,69,70,71,71,1391,1392,1396,
1252,71,71,71,71,71,71,71,71,71,71,1551,71,71